################
#T............M#
#..............#
#####......#####
#..............#
#P............P#
#.....SA.......#
#..............#
#..............#
#####......#####
#..............#
#M.....E......T#
################